111111111111111
1111CCCCC000001
111000011001C01
110000011C01C01
1P00CCC00C01C01
111110000C01C01
1CCCC0110001C01
100001111000001
1E0001111000001
111111111111111