11111111
1C0C00C1
10000E01
1C0PC001
10C000C1
11111111
