11111111111111111111111
10000000000000000000001
1001C000111100110011001
10000010101000110000001
100110100P0111100000001
100000010000000C1000001
10011110001011010000001
10000000100000000100001
10101010000111111100001
10111001000000000000001
10010000000001000111C01
10C10000101010101101101
10100011100000100001101
1000000000E000001000001
11111111111111111111111
