1111111111
1P000001E1
100C000001
1111111111