11111111111111111111111
100000001P0000000000001
10111110111111111111101
10100000100000000000101
10101111101111111110101
10101000100000000010101
10101010111111111010101
101010101000000E1010101
10101010101111111010101
1010101C100000000010101
10101011111111111110101
10101000100000000000101
10101110101111111111101
1C100000000000000000001
11111111111111111111111
