11111111111111111111111
10000000000000100C00001
1001C000111100110011001
10000010101000111000001
10011010000111100001001
10010001010000001C10101
10011110001011010001001
100C0000101000000100001
10101110000111111100E01
1011100101C100000000001
10010100000001000111C01
10C10000101010101101101
101010111000001000C1101
1P000000000011001000001
11111111111111111111111
