11111111111111111111111
1C00000000000C0000000C1
10111000111101110111001
100C101C1C10001101C1101
101110111P01111C0101101
101C001100000000110C101
100111100C1111111C01101
1000000011C00C000101001
101C1110C10111111100001
10111C11110000000000001
10C10000000111C10111C01
10110110111110111101101
101111111C000C101001101
1C000000000E000010000C1
11111111111111111111111
