11111111111111111111111
1C10100010101C1010101E1
10101010101010101010101
10101010101010101000101
10101010101C10100010C01
10001010001010101010101
10101010101010001010101
10101010101010101C10101
10101010101010101010101
1010101C100010101010101
10100010101010101010101
10101010101010101010101
10101C10101010101010C01
1P1C10101C10001C1010101
11111111111111111111111
