11111111111111111111111
1C0000000000000000000C1
10111111111111111111101
101C000000000000000C101
10101111111111111110101
10101C00000000000C10101
10101011111111111010101
1010101C0000000E1010101
10101010111111111010101
1010101C000000000C10101
10101011111111111110101
10101C0000000000000C101
10101111111111111111101
1P1C00000000000000000C1
11111111111111111111111
