11111111111111111111111
10C00000001000010000001
1011001001000001010C101
100101000000C1000011001
10010010111010100100001
10001C00000000000100001
10010010000000000100101
10000100001000000010001
1P010010001C00001100101
10000100001000010C10001
101000101010001001010E1
10010100100001000010001
10000010100100000100101
10C000000001C0000100101
11111111111111111111111
