1111111111111111111111111
1P00001000000000100000001
1000011111000011110000001
1010001000010000100001001
1000010000C00001000000001
1101111011111011111011101
1100000100000100000100001
1101011101010111010101011
1000000011110000001111001
1101010101010101010101011
1100001111000011110000101
1101110001011100010111001
1100000000100000000100001
1101011111010101111101011
1100010001000100010001001
1101111011110111101110111
1100000000001000000000001
1101010111010101011101011
1C000000000000000000000E1
1111111111111111111111111