111111111111111111111111111111
1P0000000000111100000000000001
10000F111000000011110000000011
100001000011101111000000000001
1000001C0000111100000000000001
10000F111100000011110000000001
100000111100000011110000000001
110101010101010101010101010101
10000000000C000000000011111001
100000000001111000000111100001
10000000000111100000F111100001
110101110101011101010111010101
100001111000011110000111100001
10000000000E000000000000000001
100000C111100000F1111000000001
100000000001111111111000000001
100000000001111000000111100001
110101010101010101010101010101
100001111000011110000111100001
100000F11110000001111000000001
100000000000000000000000000001
100000111000011100000111000001
110101010101110101010101010101
100000000000000C00000000000001
111111111111111111111111111111