111111111111111111111111111111111
1P0000000000111100000000000000001
100000F00011110000000000000000001
1111100000F0000000000000000000001
10000F00001111110C000000000000001
10000000000F111100000000011111111
10F0F0F0F000000000000000000000001
100001111000011110001111000111101
1000F000F000F000F000F00F000F00F01
100000111111000011111000011111111
10000000F111100000111110000000001
101010101010101010101010101010101
100000000000C00000000000000000001
10000F00001111111E000000000000001
10F00F00F00F00F00F00F00F00F00F001
100000000000000111111111110000001
1F000F000F000F000F000F00F000F00F1
101001001001001010010010010100101
1000F000F000F000F000F00F000F00F01
100000000000000000000000000000001
111111000001111100000111110000001
101010101010101010101010101010101
10000000F0000000C000000F000000001
10000F000011110000F00011110000001
101010101010101010101010101010101
10000000F0000000F000000F000000001
100000000000000000000000000000001
100110011001100110011011001101101
100000F000000F000000F000000F00001
111111111111111111111111111111111