1111111111111111111111111
1P00000000000000000000001
10000F1111000000111100001
1010001000010001000010001
1000010C00001000000000001
1011111111110000011111101
1000001000010001000010001
101010111010F010101010101
1000000F11111000000011111
1010101010101010101010101
1000001111100001111100001
1010010001001000100100101
1000000000010000000000001
1000010000C00001000000001
1101111011101101101101101
10000F1111000011111000001
1000000000001000000000001
1101010111010101110101011
1000C00000000000000000001
1111111111111111111111111