111111111111111
1P0000000C00001
100001111100001
100001000100001
101111000111101
100000000000001
101111111110101
100000100010001
1C00011111100E1
111111111111111