111111111111111111111111111111
1P0000000000111100000000000001
100001111000000011110000100001
100010000111011110000000001001
10000001C000111100001000000001
111111000001111100000111110001
100000111100000001111000000001
110101010101010101010101010101
10000000000C000000000011110001
111111000011111000011111000001
100000000001111000001111000001
110111101111011110111101110111
100000111110000011111000001101
1000000000000E0000000000000001
111111000011110000111100000111
100000000011111000011111000001
110101010101010101010101010101
100001111000011110000111100001
111110000001111000001110000001
100000011111000011111000000001
111111111111111111111111111111
100000111000011100000111000001
110101010101110101010101010101
100000000000000C00000000000001
111111111111111111111111111111