1111111111111111111111111111111111
1P00000011100000011100000011100001
1001001F01001001001001001001001001
1001001001001001001001001001001001
100001F01001C010010010010010010001
1001001001001001F01001001001001001
1001001001001001001001001001001001
100100100100100F001001001001001001
100100100100100100F001001001001011
1001001001001001001001001001001001
1001001001001001001001001001001001
1001001001001001001001001001001001
1001001001001001001001001001001001
100100100100100100E001001001001011
1001001001001001001001001001001001
1001001001001001001001001001001001
1001001001001001001001001001001001
1001001001001001001001001001001001
1001001001001001001001001001001001
1001001001001001001001001001001001
1001001001001001001001001001001001
1001001001001001001001001001001001
1001001F01001001001001001001001001
100100100100100100100C001001001001
1001001001001001001001001001001001
1001001001001001001001001001001001
1001001001001001001001001001001001
1001001001001001001001001001001001
1001001001001001001001001001001001
1111111111111111111111111111111111