11111111111111111111
1P000000000000000001
10000111100001111001
10000001111000000001
1C000000000000000001
10111111111000000001
10000100001000100001
10000000010000000001
1C000111100001111001
10101010101010101011
10000011111000001101
10000000000010000001
10001111100001111101
1C000000000000000E01
11111111111111111111