11111111111111111111
1P000000000000000001
10000F11110000111101
10000001111000000001
1C000000000000000001
10111111111000000001
10000100001000100001
10000000100000000001
1C0001111000F1111101
10101010101010101011
10000011111000001101
10000000010000000001
10001111100001111101
1C0000000000000000E1
11111111111111111111